111111111
1E1111111
11C111111
111P11111
111111111
111111111
111111111