11111111111111111111111111111111111111111111111111111
1P000000000000000000000000000000000000000000000000001
10000111100111100000000100000111100100010011110000001
10000100000100100000000100000100100110010010000000001
10000CCCC00C00C00000000C00000C00C00C0C0C00C0CC0000001
10000000100100100000000100000100100100110010010000001
10000111100111100000000111100111100100010011110000001
100000000000000000000000000000000000000000000000000E1
11111111111111111111111111111111111111111111111111111