11111111111111111111111111111111111
10000000000000000000000000000000001
10000000000000000000000000000000001
10000000000000000000000000000000001
10000000111111111111111111100000001
100000001000000C0000000000100000001
10000000101111111111111101100000001
10000000100000000C00000000100000001
10000000111110111111011111100000001
100000001P000000000C000000100000001
10000000111111110111111110100000001
100000001000000000000C0000100000001
10000000101111111110111111111110001
10000000100000C00C00C00C00000E10001
10000000111111111111111111111110001
10000000000000000000000000000000001
10000000000000000000000000000000001
10000000000000000000000000000000001
11111111111111111111111111111111111