1111111111111111111111111111111111111111
10000000000000000C01P1C00000000000000001
1010111110000000000101000000000011110101
101000001000C000000101000000C00010000101
101000C010000000000101000C00000010000101
1010000011111111111101111111111110000101
1010000000000000000000000000000000000101
1011111111111111111111111111111111111101
10C00000000000000000E0000000000000000C01
1111111111111111111111111111111111111111