11111111111
1P001111111
11101000111
11000010111
11C1100E111
11111111111