111111111111111111111111111111
1111111111111100000C1111111111
1P0000000001110000001111111111
1111011111011100110000000C1111
111001111101110011000000001111
111011111101110011111111001111
110011111100000000000000001111
1E01111111000000000000000C1111
111111111111111111111111111111