1111111
1P010E1
100C001
1001001
1111111