11111111111111
1P000000011111
111111110110E1
11111000011011
11111011111011
11100000000011
11111011111111
11111000C11111
11111111111111