1111111111
1000100011
1P00E000C1
1000100011
1000100001
1000100001
1000100001
1000000001
1111111111