11111111111111111111111111
1P0000000000111111111000E1
11111111111011111111101111
11111111111011111111101111
11111110000000001111101111
11111111111011101111101111
11110000000000001111101111
11110111111011111111101111
11110001111000000000001111
11110000011111111111111111
11110000011111111111111111
1C000111111111111111111111
11111111111111111111111111