111111111111111
1P0000000C0C0C1
111111111111101
1E0000000C0C0C1
111111111111111