11111111111111111111111111111111
1P000C0000C0000C0000C0000C000001
111111111111111111111111100C0001
1000000000000000000000001000C001
100000000000000000000000100000C1
10000000000000000000000011111101
1001C0000000000000000000000001C1
10011111111111111111111111111101
1001E0000000000000000000000000C1
10000000000000000000000000000001
10000000000000000000000000000001
100000000000000000000000000000C1
10000000000000000000000000000001
100C000000000000000000000C0000C1
11111111111111111111111111111111