111111111111111111111
1100001111000001111E1
110010111101110001101
110C100000001100C1101
111110111110111111101
1P0000111110000000001
111111111111111111111