11111111111111111111111111111111111111111
1P000000000000000000010000000000000000001
10111111111111111111010000000000000000001
10000000000000000001011111111111111000001
1000000000000000000101C000000000001000001
1000000000000000000101CCCC000000001000001
10000000000000000001011111111111001000001
10000000000000000001000000000000001000001
10000000000000000001011111111111111000001
10000000000000000001010000000000000000001
10000000000000000001E10000000000000000001
11111111111111111111111111111111111111111