111111111111111111111111
1P0000000000000000000001
101111111111111111111101
101111111111111111111101
100000000000000000000001
111011111110111111111111
1C00111111100000000000E1
111111111111111111111111